05 05 05 05 05 05 05 05 05 05 14 17 02 02 02 02 02 02 02 02 02 02 02 02 02 02 02 02 02 02 02 02 02 02 02 02 02 02 02 02 02 02 02 02 02 02 02 02 02 02
04 00 00 04 00 00 00 00 00 04 10 02 02 02 02 02 02 02 02 02 02 02 02 02 02 02 02 02 02 02 02 02 02 02 02 02 02 02 02 02 02 02 02 02 02 02 02 02 02 02
04 00 00 00 00 00 00 00 00 14 17 02 02 15 08 08 08 08 08 08 08 08 08 08 08 08 08 08 08 08 08 08 08 08 16 02 02 02 02 02 02 02 02 02 02 02 02 02 02 02
04 00 00 00 00 00 00 00 14 17 02 02 02 09 00 00 00 00 00 00 00 00 00 00 00 00 00 00 00 00 00 00 00 00 11 08 16 02 02 02 02 02 02 02 02 02 02 02 02 02 
04 04 00 00 00 00 00 14 17 02 02 02 15 12 00 04 00 00 40 03 03 03 03 03 03 03 03 00 00 00 00 00 00 00 00 00 11 08 16 02 02 02 02 02 02 02 02 02 02 02 
07 07 07 05 05 07 07 17 02 02 02 15 12 00 00 00 00 00 03 05 05 05 03 05 05 05 03 00 00 00 00 00 00 00 04 00 00 00 11 08 16 02 02 02 02 02 02 02 02 02 
02 02 02 03 03 02 02 02 02 02 02 09 00 00 00 00 00 00 03 05 05 05 03 05 05 05 03 00 00 00 00 00 00 00 00 00 00 00 00 00 11 08 16 02 02 02 02 02 02 02 
02 02 02 03 03 02 02 02 02 02 15 12 00 00 00 00 00 00 03 03 05 03 03 03 05 03 03 00 00 00 00 00 00 00 00 00 00 00 00 00 00 00 11 16 02 02 02 02 02 02
02 02 02 03 03 02 02 02 02 02 09 00 00 00 00 04 00 00 03 05 05 05 05 05 05 05 03 00 00 00 00 00 00 04 00 00 00 00 00 00 00 00 00 10 02 02 02 02 02 02 
02 02 02 03 03 02 02 02 02 15 12 00 00 00 00 00 00 00 03 05 05 05 05 05 05 05 03 00 04 00 00 00 00 00 00 00 00 00 00 00 00 00 00 10 02 02 02 02 02 02 
02 02 02 03 03 02 02 02 02 09 00 00 00 00 00 00 00 04 03 05 05 05 05 05 05 05 03 00 00 00 00 00 00 00 00 00 00 00 00 00 00 00 00 10 02 02 02 02 02 02 
02 02 02 03 03 02 02 02 15 12 00 00 00 00 00 00 00 00 03 03 03 03 05 03 03 03 03 00 00 00 00 00 00 00 00 00 00 04 00 00 00 00 14 17 02 02 02 02 02 02 
02 02 02 03 03 02 02 02 09 00 00 00 00 00 00 00 00 00 00 00 00 00 05 00 00 00 00 00 00 00 00 00 00 00 00 00 00 00 00 00 14 07 17 02 02 02 02 02 02 02 
08 08 08 03 03 08 08 08 12 00 00 00 00 00 00 00 00 00 00 00 00 05 05 00 00 00 00 00 00 00 00 00 00 00 00 00 00 00 14 07 17 02 02 02 02 02 02 02 02 02 
04 00 00 05 05 00 00 00 00 00 00 00 00 00 04 00 00 00 00 00 05 05 00 00 00 00 00 00 00 00 00 04 00 00 00 00 00 00 10 02 02 02 02 02 02 02 02 02 02 02 
04 00 00 05 05 00 00 00 00 00 00 00 00 00 00 00 00 00 00 05 05 00 00 00 00 00 00 00 00 00 00 00 00 00 00 00 00 00 10 02 02 02 02 02 02 02 02 02 02 02 
04 00 00 00 05 05 00 00 00 00 00 00 00 00 00 00 00 00 00 05 05 00 00 04 00 00 00 00 00 00 00 00 00 00 00 00 00 14 17 02 02 02 02 02 02 02 02 02 02 02 
04 00 00 00 00 05 05 05 05 05 05 05 05 05 05 05 05 05 05 05 05 00 00 00 00 00 00 04 00 00 00 00 00 00 00 00 14 17 02 02 02 02 02 02 02 02 02 02 02 02 
04 00 00 00 00 00 05 05 05 05 05 05 05 05 05 05 05 05 05 05 00 00 00 00 00 00 00 00 00 00 00 00 00 00 14 07 17 02 02 02 02 02 02 02 02 02 02 02 02 02 
04 00 00 00 00 05 05 00 00 00 00 00 00 00 00 00 04 00 00 05 05 00 00 00 00 00 00 00 00 14 07 07 07 07 17 02 02 02 02 02 02 02 02 02 02 02 02 02 02 02
04 00 00 00 00 05 05 00 00 00 00 00 00 00 00 00 00 00 00 05 05 00 00 00 00 00 00 00 14 17 02 02 02 02 02 02 02 15 16 02 02 02 02 02 02 02 02 02 02 02 
04 00 00 00 05 05 00 00 00 04 00 00 00 04 00 00 00 00 00 00 05 05 00 00 00 00 00 00 10 02 02 02 02 02 02 02 15 12 10 02 02 02 02 02 02 02 02 02 02 02 
04 00 00 05 05 00 00 00 00 00 00 00 00 00 00 00 00 00 00 00 05 05 00 00 00 00 00 00 10 02 02 02 02 02 02 15 12 00 11 08 08 08 16 02 02 02 02 02 02 02 
04 00 00 05 05 00 00 00 00 00 00 00 00 00 00 00 00 00 00 00 00 05 05 05 05 05 05 05 10 02 02 02 02 02 02 09 00 00 00 00 03 03 17 02 02 02 02 02 02 02 
04 00 00 05 05 00 00 00 00 00 00 00 00 00 00 00 00 00 00 00 00 00 00 00 00 00 00 00 11 16 02 02 02 15 08 12 00 00 00 14 03 03 02 02 02 02 02 02 02 02 
04 00 00 05 05 00 00 00 00 00 00 00 04 00 00 00 00 00 00 00 00 00 00 00 00 00 00 00 00 11 16 02 15 12 00 00 00 00 14 17 03 03 02 02 02 02 02 02 02 02 
04 00 00 05 05 00 00 00 00 00 00 00 00 00 00 04 00 00 00 00 00 00 00 04 00 00 00 00 00 00 11 08 12 00 00 00 00 00 10 02 03 03 02 02 02 02 02 02 15 08 
04 00 00 05 05 00 00 00 04 00 00 00 00 00 00 00 00 00 00 00 00 00 00 00 00 00 00 00 00 00 00 00 00 00 00 00 00 14 17 02 03 03 02 02 02 02 02 02 09 04 
04 00 05 05 00 00 00 00 00 00 04 04 04 00 00 00 00 00 00 00 00 00 00 00 00 00 00 00 04 00 00 00 00 00 00 00 00 10 02 02 03 03 02 02 02 02 02 15 12 04 
04 00 05 05 00 00 00 00 00 04 04 00 04 00 00 00 00 00 00 00 00 00 00 00 00 00 00 00 00 00 00 00 00 00 04 00 14 17 02 02 03 03 02 15 08 08 08 12 00 04 
04 00 05 05 00 04 04 00 04 00 00 00 04 00 00 00 00 00 00 00 00 00 00 00 00 00 00 00 00 04 00 00 00 00 00 00 10 02 02 02 03 03 02 09 00 00 00 00 00 04 
04 00 05 05 00 00 00 04 00 00 00 00 00 00 00 00 00 04 00 00 00 00 00 00 04 00 00 00 00 00 00 00 00 00 14 07 17 02 02 02 03 03 08 12 00 00 00 00 00 04 
04 04 05 05 04 00 00 00 00 00 00 00 00 00 00 00 00 00 00 00 00 00 00 00 00 00 00 00 00 00 00 00 00 00 10 02 02 02 02 15 03 03 00 00 00 00 00 00 00 04 
04 04 05 05 00 00 00 00 00 00 00 00 00 00 00 00 00 00 00 00 00 00 00 00 00 00 00 00 00 00 00 00 00 00 10 02 02 02 02 18 13 00 00 00 00 00 00 00 00 04 
04 04 00 05 05 00 00 00 00 00 00 00 00 00 00 00 00 00 00 00 00 00 00 00 00 00 00 04 00 00 00 00 00 00 10 02 02 02 02 02 09 00 00 00 00 00 00 00 00 04 
04 00 00 05 05 00 00 04 00 00 00 00 00 00 00 00 00 00 00 00 00 00 00 00 00 00 00 00 00 00 04 00 00 14 17 02 02 02 02 02 18 07 07 07 13 00 00 00 00 04 
04 00 00 00 05 05 00 00 00 00 00 04 00 00 00 00 00 00 00 00 00 00 00 00 04 00 00 00 00 00 00 00 00 10 02 02 02 02 02 02 02 02 02 02 18 07 13 00 00 04 
04 00 00 00 00 05 05 00 00 00 00 00 00 00 00 00 00 00 04 00 00 00 00 00 00 00 00 00 00 00 00 00 00 10 02 02 02 02 02 02 02 02 02 02 02 02 18 13 00 04 
04 00 00 00 00 05 05 00 00 00 00 00 00 00 00 00 00 00 00 00 00 00 00 00 00 00 00 00 00 00 00 00 00 10 02 02 02 02 02 02 02 02 02 02 02 02 02 18 07 13 
04 00 00 00 00 05 05 00 00 00 00 04 00 00 00 00 00 00 00 00 00 00 00 00 00 04 00 00 00 00 00 00 00 10 02 02 02 02 02 02 02 15 08 08 16 02 02 02 02 18 
04 00 00 00 00 05 05 00 00 00 00 00 00 00 00 00 00 00 00 04 00 00 00 00 00 00 00 00 00 00 00 14 07 17 02 02 02 02 02 02 15 12 00 00 11 08 16 02 02 02 
04 04 00 00 00 05 05 00 00 00 04 00 00 00 00 00 00 00 00 00 00 00 00 00 00 00 00 00 00 00 00 10 02 02 02 02 02 02 02 15 12 00 00 00 00 00 11 16 02 02 
04 00 00 00 00 00 05 05 00 00 00 00 00 00 00 00 00 00 00 00 00 00 04 00 00 00 00 00 00 00 00 10 02 02 02 02 02 02 15 12 00 00 00 00 00 00 00 11 16 02 
04 00 00 00 00 00 00 05 05 00 00 00 00 00 00 04 00 00 00 00 00 00 00 00 00 00 00 00 00 00 00 10 02 02 02 02 02 15 12 00 00 00 00 00 00 00 00 00 11 16 
04 00 00 00 00 00 00 05 05 00 00 00 00 00 00 00 00 00 00 00 00 00 00 00 00 00 00 00 00 00 00 03 03 03 03 03 03 03 03 00 00 00 00 00 00 00 00 00 00 11 
04 00 00 04 00 00 00 00 00 00 00 00 00 00 00 04 04 04 04 00 00 00 00 00 04 04 00 00 00 00 00 03 03 03 03 03 03 03 03 00 00 00 00 00 00 00 00 00 00 04 
04 00 00 00 00 00 00 00 00 00 00 00 00 00 04 04 00 00 00 04 04 05 04 04 00 00 04 04 00 00 00 10 02 02 02 02 15 12 00 00 00 00 00 00 00 00 00 00 00 04 
04 00 00 00 00 00 04 00 00 00 00 00 00 04 00 00 00 00 00 00 00 05 00 00 00 00 00 04 00 00 14 17 02 02 02 02 09 00 00 00 00 00 00 00 00 00 00 00 00 04 
04 00 00 00 00 00 00 00 00 00 00 00 04 00 00 00 00 00 00 00 00 05 00 00 00 00 00 00 04 00 10 02 02 02 02 02 09 00 00 00 00 00 00 00 00 00 00 00 00 04 
04 04 04 04 04 04 04 04 04 04 04 04 04 04 04 04 04 04 04 04 04 04 04 04 04 04 04 04 00 04 10 02 02 02 02 02 09 04 04 04 04 04 04 04 04 04 04 04 04 04 