02 15 08 08 08 08 16 03 03 03 03 03 03 03 03 03 03 03 03 03 03 03 03 05 10 02 02 02 02 02 02 02 02 18 17 02 02 02 02 02 02 02 02 02 02 02 02 02 02 02 
02 18 07 07 07 07 17 02 02 18 03 17 02 02 02 02 02 02 02 02 02 09 05 14 17 02 02 02 02 02 02 02 02 02 02 02 02 02 02 02 02 02 02 02 02 02 02 02 02 02 
02 02 02 02 02 02 02 02 02 02 03 02 02 02 02 02 02 02 02 02 02 09 05 10 02 02 02 02 02 02 02 02 02 02 02 02 02 02 02 02 02 02 02 02 02 02 02 02 02 02 
02 02 02 02 15 16 02 02 02 02 03 02 02 02 15 08 08 16 02 02 02 09 05 10 02 02 02 02 15 08 16 02 02 02 02 15 16 02 02 02 02 02 02 02 02 02 15 08 08 16 
02 02 15 08 12 10 02 02 02 02 03 02 02 02 09 05 14 17 02 02 15 12 05 11 16 02 15 08 12 05 10 02 02 15 08 12 10 02 02 15 08 08 16 02 02 02 09 05 05 10 
08 08 12 03 03 10 02 02 15 08 03 08 16 02 18 07 17 02 02 02 09 05 05 00 11 08 12 00 00 05 11 08 08 12 05 05 11 08 08 12 00 00 11 08 08 08 12 00 05 11 
03 03 03 03 03 10 02 02 09 05 03 05 10 02 02 02 02 02 15 08 12 00 00 00 00 05 05 00 00 00 00 00 00 00 00 04 00 00 00 00 00 00 00 00 05 05 00 00 00 00 
03 03 03 03 03 10 02 02 18 03 03 03 11 08 08 08 08 08 12 01 00 00 00 00 00 00 00 00 00 00 00 00 00 00 00 04 00 00 00 04 00 00 00 00 00 00 00 00 00 00 
07 07 13 03 03 03 03 03 03 03 03 03 03 03 03 03 03 03 03 01 00 00 00 00 00 00 00 00 00 04 00 00 00 00 00 00 04 00 00 00 00 00 00 00 00 00 00 00 00 00 
02 02 09 03 03 03 03 03 03 03 03 03 03 03 03 03 03 03 03 03 01 00 00 00 00 00 00 00 00 00 00 04 00 00 00 00 00 00 00 00 00 00 00 00 04 00 00 00 04 00 
02 02 18 13 05 10 02 02 02 03 03 03 09 03 10 02 02 02 03 03 03 01 00 00 05 05 00 00 00 00 00 00 00 00 00 00 00 04 00 00 00 00 00 00 00 04 00 00 00 00 
16 02 02 18 07 17 02 02 02 02 02 02 09 03 10 02 02 02 02 03 03 03 01 00 00 00 00 04 00 00 00 00 00 00 00 00 00 04 04 00 00 00 00 00 00 04 00 00 00 00 
10 02 02 02 02 02 15 08 16 02 02 02 09 03 10 02 02 02 15 01 01 03 03 01 00 00 00 00 00 00 00 00 00 00 00 00 00 00 00 00 00 04 00 00 00 00 00 00 00 00 
11 08 16 02 02 02 09 05 10 02 02 02 09 03 10 02 02 02 09 05 01 01 03 03 01 00 00 00 04 04 00 00 00 00 00 00 00 00 04 04 00 00 00 00 00 00 00 00 00 00 
05 05 11 16 02 02 09 05 11 16 02 02 09 03 10 02 02 02 09 05 04 00 01 03 03 01 00 00 00 00 00 00 00 00 00 00 00 00 00 00 00 00 00 00 00 00 00 00 00 00 
00 00 05 10 02 02 18 07 13 03 03 03 03 03 11 16 02 02 18 13 00 00 00 01 03 03 01 00 00 00 04 00 00 00 00 00 00 00 00 00 00 00 00 00 00 00 00 00 00 00 
00 00 05 10 02 02 02 02 18 03 02 02 02 18 07 17 02 02 02 09 00 00 00 00 01 03 03 01 00 00 00 00 00 00 00 00 00 04 00 00 00 00 04 00 00 00 00 00 04 00 
00 00 05 11 16 02 02 02 02 03 02 02 02 02 02 02 02 02 02 18 13 00 00 00 00 01 03 03 01 00 00 00 04 04 00 00 00 00 00 00 00 00 00 00 00 00 00 00 00 00 
05 00 05 05 11 08 16 02 02 03 02 02 02 15 08 08 16 02 02 02 09 04 00 00 00 00 01 03 03 01 00 00 00 01 01 01 01 00 00 00 00 00 01 01 01 01 00 00 00 00 
05 05 14 07 07 13 11 16 02 03 02 02 02 09 03 03 10 02 02 02 09 00 04 00 00 00 00 01 03 03 01 00 01 01 03 03 01 01 01 00 01 01 01 03 03 01 01 00 00 00 
05 05 10 02 02 09 03 03 03 03 03 03 03 03 03 03 10 02 15 08 12 00 00 00 00 00 00 00 01 03 03 01 01 03 03 03 03 03 01 01 01 03 03 03 03 03 01 01 00 00 
05 05 10 02 02 09 03 03 03 03 03 02 02 18 07 03 17 02 09 05 04 00 04 00 00 00 00 00 00 01 03 03 03 03 03 03 03 03 03 01 03 03 03 03 03 03 03 01 01 00 
00 00 10 02 02 18 17 02 02 02 02 02 02 02 02 03 02 02 18 13 00 00 00 00 04 00 00 00 00 00 01 03 03 01 03 03 01 03 03 01 03 03 01 03 03 01 03 03 01 00 
00 00 10 02 02 15 08 08 08 08 16 02 02 02 02 03 15 08 16 09 00 00 00 00 00 00 00 00 00 00 01 03 03 03 03 03 03 03 01 03 03 03 03 03 03 03 03 03 01 00 
00 05 10 02 02 09 05 05 05 05 10 02 02 15 08 03 12 05 10 09 00 00 00 00 00 00 00 00 00 00 01 03 03 03 03 03 03 03 03 01 03 01 03 03 01 03 03 03 03 03 
00 05 10 02 02 09 14 07 07 13 10 02 02 09 05 03 14 07 17 09 00 00 00 00 00 00 00 00 00 00 01 03 03 01 03 03 03 01 01 03 03 03 03 03 03 03 03 03 01 00 
00 05 11 08 08 12 11 16 02 18 17 02 15 12 00 00 10 02 02 09 00 00 00 00 00 04 00 00 00 04 01 03 03 03 03 01 03 03 01 03 03 03 01 03 01 03 01 03 01 00 
05 05 00 00 00 00 00 10 02 02 02 02 09 00 00 00 11 08 08 12 00 00 00 00 00 00 00 00 00 00 01 03 01 01 01 01 03 03 01 01 03 01 03 03 03 03 01 03 01 14 
00 00 00 00 00 00 00 11 08 16 02 02 09 00 00 00 00 00 00 00 00 00 04 00 00 00 00 00 00 00 00 01 03 03 03 03 03 01 03 03 03 01 03 03 01 03 03 01 00 10 
00 00 00 00 00 00 00 00 00 03 03 03 03 00 00 00 00 00 00 00 00 00 00 00 04 00 00 00 00 00 00 01 03 03 03 01 01 01 03 01 01 03 03 03 03 01 03 01 00 10 
00 00 00 00 00 00 00 00 00 03 03 03 03 00 04 00 04 00 00 00 00 00 00 00 00 00 00 00 00 00 00 01 01 03 03 03 03 03 03 01 03 01 03 03 03 03 01 01 14 17 
00 00 00 00 00 00 00 14 07 17 02 02 09 00 00 00 00 00 00 00 00 00 04 00 00 00 00 04 00 04 00 00 01 01 03 03 03 01 03 01 03 03 03 01 03 01 01 00 10 02 
04 00 00 00 00 00 14 17 02 02 02 02 18 07 07 13 00 00 00 00 00 00 00 00 00 04 00 00 04 00 00 00 05 01 03 03 03 03 03 01 03 01 03 03 03 03 00 00 10 02 
00 00 04 00 00 00 10 02 02 02 02 02 02 02 02 09 00 00 00 00 00 00 00 00 00 00 00 00 00 00 00 00 05 01 01 03 03 03 03 01 03 03 03 03 01 03 03 14 17 02 
00 00 00 00 00 00 10 02 02 02 02 02 02 02 02 09 00 00 00 04 00 00 00 00 00 00 00 00 00 00 00 00 00 00 01 01 03 03 01 03 03 03 03 01 01 03 03 10 02 02 
00 00 00 00 00 00 11 08 08 08 16 02 02 15 08 12 04 04 00 00 00 00 00 00 00 00 00 00 00 00 00 00 00 05 05 01 01 03 03 01 03 03 01 01 00 03 14 17 02 02 
00 04 00 00 00 04 00 05 05 14 17 02 02 09 00 00 00 00 00 04 00 00 00 00 00 00 00 04 04 00 00 00 00 00 05 00 01 01 01 03 01 01 01 00 00 03 10 02 02 15 
00 00 04 00 00 00 00 00 14 17 02 02 15 12 00 00 00 00 00 00 00 04 00 00 00 04 00 00 00 00 00 00 00 00 00 04 00 00 01 01 01 00 00 00 00 03 10 02 02 09 
04 00 00 00 00 00 00 00 10 02 02 02 09 05 00 00 00 00 00 00 00 00 00 00 00 00 00 00 00 00 00 00 00 04 00 00 00 00 00 01 00 00 00 00 00 03 10 02 02 09 
00 00 00 00 00 00 00 00 11 16 02 02 18 07 07 07 07 07 07 07 07 07 07 07 07 07 07 07 07 07 07 07 07 07 07 07 07 07 07 07 07 07 07 07 13 03 10 02 02 09 
05 05 05 05 05 05 05 05 05 10 02 02 02 02 02 02 02 02 02 02 02 02 02 02 02 02 02 02 02 02 02 02 02 02 02 02 02 02 02 02 02 02 02 02 09 03 03 03 03 03 
00 00 04 00 00 00 00 00 04 10 02 02 02 02 02 02 02 02 02 02 02 02 02 02 02 02 02 02 02 02 02 02 02 02 02 02 02 02 02 02 02 02 02 02 18 03 17 02 02 09 
00 00 00 00 00 00 00 00 14 17 02 02 15 08 08 08 08 08 08 08 08 08 08 08 08 08 08 08 08 08 08 08 08 16 02 02 02 02 02 02 02 02 02 02 02 03 02 02 02 09 
00 00 00 00 00 00 00 14 17 02 02 02 09 00 00 00 00 00 00 00 00 00 00 00 00 00 00 00 00 00 00 00 00 11 08 16 02 02 02 02 02 02 02 02 02 03 02 02 02 09 
04 00 00 00 00 00 14 17 02 02 02 15 12 00 04 00 00 01 01 01 01 01 01 01 01 01 00 00 00 00 00 00 00 00 00 11 08 16 02 02 02 02 02 02 02 03 02 02 02 09 
05 05 03 03 05 14 17 02 02 02 15 12 00 00 00 00 00 01 05 05 05 01 05 05 05 01 00 00 00 00 00 00 00 04 00 00 00 11 08 16 02 02 02 02 02 03 02 02 02 09 
07 07 03 03 07 17 02 02 02 02 09 00 00 00 00 00 00 01 05 05 05 01 05 05 05 01 00 00 00 00 00 00 00 00 00 00 00 00 00 11 08 16 02 02 02 03 02 02 02 09 
02 02 03 03 02 02 02 02 02 15 12 00 00 00 00 00 00 01 01 05 01 01 01 05 01 01 00 00 00 00 00 00 00 00 00 00 00 00 00 00 00 11 16 02 02 03 02 02 02 09  
02 02 03 03 02 02 02 02 02 09 00 00 00 00 04 00 00 01 05 05 05 05 05 05 05 01 00 00 00 00 00 00 04 00 00 00 00 00 00 00 00 00 10 02 15 03 16 02 15 12  
02 02 03 03 02 02 02 02 15 12 00 00 00 00 00 00 00 01 05 05 05 05 05 05 05 01 00 04 00 00 00 00 00 00 00 00 00 00 00 00 00 00 03 03 03 03 03 03 03 05  
