00 00 00 04 00 00 00 00 04 00 00 00 00 00 00 00 00 00 00 00 00 00 04 00 11 16 18 7 7 7 7 7 7 7 7 7 7 7 7 7 7 7 7 7 7 7 7 7 7 7  
00 00 00 00 00 00 00 00 00 00 00 00 00 00 00 04 00 00 00 04 00 00 00 00 00 11 8 8 8 8 8 8 8 8 8 8 8 8 8 8 8 8 8 8 8 8 8 8 8 8  
00 00 00 00 00 04 00 00 00 04 00 00 00 00 00 00 01 01 01 01 01 01 01 01 01 01 01 01 01 01 01 01 01 01 01 01 01 01 01 01 01 01 01 01 01 01 01 01 01 01  
00 00 00 00 00 00 04 04 00 00 00 00 00 01 01 01 03 03 03 03 03 03 03 03 03 03 03 01 05 05 05 05 05 05 05 05 05 05 05 05 05 05 05 05 05 05 05 05 05 05  
00 00 00 00 00 00 00 00 04 00 00 01 01 03 03 03 03 03 01 01 01 01 01 01 01 03 03 03 01 05 05 05 05 05 05 05 05 05 05 05 05 05 05 05 05 05 05 05 05 05  
00 00 00 00 04 00 04 04 00 01 01 03 03 03 03 01 01 01 00 00 00 00 00 00 00 01 01 03 03 01 05 05 05 05 05 05 05 05 06 05 06 05 05 05 05 05 05 06 05 05  
00 00 00 04 00 00 00 01 01 03 03 03 01 01 01 00 00 00 00 00 00 00 00 00 00 00 00 01 03 01 05 05 05 05 05 05 06 06 05 05 05 05 05 05 05 05 05 05 05 05  
00 00 00 00 00 01 01 03 03 03 01 01 00 00 00 00 00 00 00 00 00 00 00 00 00 00 00 01 03 01 05 05 05 05 05 05 05 05 05 05 05 05 05 05 05 05 05 05 06 05  
00 00 00 01 01 03 03 03 01 01 00 00 00 00 00 00 04 00 00 00 00 00 00 00 00 00 00 01 03 01 05 05 05 05 05 05 05 05 05 05 05 05 05 05 05 05 05 06 05 05  
00 01 01 03 03 03 00 00 00 00 00 00 00 00 00 00 00 00 00 00 00 00 00 00 00 00 00 01 03 01 05 05 05 05 05 05 05 05 05 05 05 05 05 05 05 05 05 05 05 05  
01 03 03 03 01 01 01 01 01 01 01 01 01 01 01 01 01 01 01 01 01 01 01 00 00 00 00 01 03 01 05 05 05 05 06 05 06 05 05 05 05 05 05 05 05 05 05 05 05 05 
03 03 01 01 01 01 01 03 03 03 03 03 03 03 03 03 03 03 03 03 03 03 03 01 01 01 00 01 03 01 05 05 05 05 05 05 05 05 05 05 05 05 05 05 05 05 05 05 05 05  
03 01 01 03 03 03 03 03 01 00 01 01 01 01 01 01 01 01 01 01 01 01 03 03 03 03 01 03 01 00 05 05 05 05 05 05 06 05 05 05 05 05 05 05 05 05 05 05 05 05  
03 03 03 03 01 01 01 01 00 00 00 00 00 00 00 00 00 00 00 00 00 00 01 01 01 03 03 03 01 00 05 05 06 05 05 06 05 05 06 05 05 05 06 06 06 05 06 05 06 06  
03 03 01 01 01 01 01 00 00 00 00 00 00 00 00 00 00 00 00 00 00 00 00 00 00 01 03 03 03 00 05 05 05 05 06 05 05 06 06 06 05 06 05 06 05 05 05 05 06 06  
03 03 03 03 03 03 03 01 01 01 01 01 00 00 00 00 00 00 00 00 00 01 01 01 01 03 03 03 01 04 05 05 05 05 05 05 05 05 05 05 05 05 05 05 06 06 05 06 05 05  
03 03 01 01 01 01 03 03 03 03 03 03 01 01 01 01 01 01 01 01 01 03 03 03 03 03 01 03 01 04 05 05 05 00 00 05 05 06 06 05 06 05 05 05 06 06 05 05 05 05 
01 03 03 03 01 01 01 00 01 01 03 03 03 03 03 03 03 03 03 03 03 03 03 03 01 01 01 03 01 00 05 05 00 00 00 00 00 05 06 06 06 06 05 05 06 06 06 05 06 06  
04 01 01 03 03 01 01 00 00 00 01 01 01 01 01 01 01 01 01 01 01 01 01 01 00 00 01 03 03 01 05 05 04 00 04 04 00 00 05 05 05 05 05 06 06 06 06 05 05 05  
04 04 04 01 03 03 03 01 00 00 00 00 00 00 00 00 00 00 00 00 00 00 00 00 00 00 00 01 03 01 05 05 00 03 04 04 04 00 00 05 04 03 05 05 05 05 05 05 05 03 
04 04 04 04 01 01 03 03 03 01 00 00 00 00 00 00 00 00 00 00 00 00 00 00 00 00 00 01 03 01 05 05 04 03 04 04 04 04 04 04 04 03 00 05 03 04 04 04 05 04  
04 04 04 04 04 04 01 01 03 03 01 01 00 00 00 00 00 00 00 00 00 00 00 00 00 00 00 01 03 01 05 05 00 03 04 04 04 03 04 04 04 03 04 04 04 03 04 05 05 04  
04 04 04 04 04 04 04 04 01 03 03 03 01 01 01 00 00 00 00 00 00 00 00 00 00 00 01 03 03 01 05 05 04 03 04 04 04 03 04 04 04 03 04 04 04 04 03 04 04 04  
04 04 04 04 04 04 04 04 04 01 01 03 03 03 03 01 01 01 01 00 00 00 00 00 00 01 01 03 01 04 05 05 04 03 04 03 03 03 03 03 04 03 04 04 04 04 04 03 04 03  
04 04 04 04 04 04 04 04 04 04 04 01 01 03 03 03 03 03 03 01 01 01 01 01 01 03 03 03 01 04 05 05 04 03 04 04 04 03 04 04 04 03 04 04 04 04 03 04 04 03  
04 04 04 04 04 04 04 04 04 04 04 04 04 01 01 01 03 03 03 03 03 03 03 03 03 03 03 01 04 04 05 05 04 03 04 04 04 03 04 04 04 03 04 04 04 03 04 04 04 03  
04 04 04 04 04 04 04 04 04 04 04 04 04 04 04 04 01 01 01 01 01 01 01 01 01 01 01 04 04 04 05 05 00 03 04 04 04 04 04 04 04 03 04 04 03 04 04 04 04 03  
04 04 04 04 04 04 04 04 04 04 04 04 04 04 04 04 04 04 04 04 04 04 04 04 04 04 04 04 04 04 05 05 00 03 04 04 04 04 04 04 04 03 04 04 04 04 04 04 04 03 
05 05 05 05 05 05 05 05 05 05 05 05 05 05 05 05 05 05 05 05 05 05 05 05 05 05 05 05 05 05 05 05 05 05 05 05 04 04 04 04 04 04 04 04 04 04 04 04 04 04  
05 05 05 05 05 05 05 05 05 05 05 05 05 05 05 05 05 05 05 05 05 05 05 05 05 05 05 05 05 05 05 05 05 05 05 05 04 04 04 04 04 05 05 05 05 05 00 00 00 00  
04 00 00 04 00 04 04 04 04 04 04 04 04 04 04 04 04 04 04 04 04 04 04 04 04 04 04 04 04 04 04 04 04 04 05 05 05 05 05 05 05 05 04 04 04 04 04 04 04 04  
04 04 00 00 04 04 04 04 04 04 04 04 04 04 04 04 04 04 04 04 04 04 04 04 04 04 04 04 04 04 04 04 04 04 05 05 05 05 05 04 04 04 04 04 04 04 04 04 04 04  
04 04 00 04 04 00 00 04 04 04 04 04 04 04 04 04 04 04 01 01 01 01 01 01 04 04 04 04 04 04 04 04 01 04 04 04 04 04 04 04 01 04 04 04 01 01 01 04 04 04  
04 00 04 04 04 04 00 04 04 04 04 04 04 04 04 04 04 04 01 04 04 04 04 04 04 04 04 04 04 04 04 04 01 01 00 04 00 00 04 04 01 00 00 01 00 04 00 04 00 01  
04 04 04 04 04 04 00 04 04 04 04 04 04 04 04 04 04 04 01 04 04 04 04 04 04 04 04 04 04 04 04 04 01 04 01 00 04 04 01 04 01 04 00 01 04 00 00 00 01 00  
04 04 04 04 04 04 04 04 04 04 04 04 04 04 04 04 04 04 01 04 04 04 04 04 04 01 01 01 01 01 01 04 01 04 01 00 00 00 01 04 01 04 00 01 04 04 00 00 01 01  
04 04 04 04 04 04 04 04 04 04 04 04 04 04 04 04 04 04 01 04 04 04 04 04 04 04 04 04 04 04 04 04 01 04 01 00 04 00 01 04 01 04 01 04 04 00 04 00 04 00  
04 04 04 00 00 04 04 00 04 00 04 00 04 00 04 04 04 04 01 01 01 01 01 01 04 04 04 00 04 04 00 00 01 00 01 00 04 00 01 00 01 00 01 00 04 04 04 04 04 04  
00 04 00 00 04 00 00 04 04 04 04 00 00 00 04 04 04 04 01 00 00 04 00 00 00 00 04 04 04 00 04 04 01 00 04 01 00 01 00 00 01 04 01 00 04 04 04 00 00 00  
00 00 04 04 00 00 04 00 04 04 00 00 00 04 00 04 00 04 01 00 00 04 04 00 04 01 01 01 01 01 01 04 01 00 04 01 04 01 00 00 01 00 01 00 04 04 00 04 04 04 
04 04 04 04 00 00 04 00 00 00 00 00 00 00 04 04 00 00 01 00 00 04 04 00 00 04 00 04 04 00 04 04 01 04 00 01 00 01 00 00 01 00 00 01 04 00 04 04 04 00  
04 00 00 00 04 04 00 00 04 04 04 00 00 00 04 00 00 00 01 04 00 00 04 00 04 00 00 00 00 00 04 00 01 00 04 01 00 01 00 00 01 00 00 01 04 00 04 00 04 00 
00 00 00 00 00 00 00 00 00 00 00 00 00 00 00 00 00 00 01 00 00 00 00 00 00 00 00 00 00 00 00 00 01 00 00 00 01 00 00 00 01 00 00 01 00 00 00 00 00 00  
00 00 00 00 00 00 00 04 00 00 00 00 00 00 00 00 00 00 01 01 01 01 01 01 00 00 00 00 00 00 00 00 01 00 00 00 01 00 00 00 01 00 00 00 01 01 01 00 00 00  
00 00 00 00 00 00 00 00 00 00 00 00 00 00 00 00 00 00 00 00 04 00 00 00 00 00 04 00 00 00 00 00 00 00 00 00 00 00 00 00 00 00 00 00 00 00 00 00 00 00  
01 01 01 01 01 01 01 01 01 01 01 01 01 01 01 01 01 01 01 01 01 01 01 01 01 01 01 01 01 01 01 01 01 01 01 01 01 01 01 01 01 01 01 01 01 01 01 01 01 01  
04 00 04 04 00 04 00 04 04 04 04 04 04 04 00 04 04 04 04 04 04 04 04 00 04 04 04 04 00 04 04 04 04 04 00 04 04 04 04 00 04 00 04 04 04 04 00 04 04 04 
04 04 04 04 04 00 04 04 04 04 04 04 04 04 00 04 04 00 04 04 04 04 04 04 04 04 04 04 04 04 04 04 04 04 04 04 04 04 00 04 00 04 04 04 04 04 04 04 04 04 
04 04 04 04 04 04 04 04 04 04 04 00 04 04 04 00 04 04 04 04 04 04 04 04 04 04 04 04 04 04 04 04 04 04 04 00 04 04 04 04 04 04 04 04 04 04 00 00 04 04  
04 04 04 04 04 04 04 04 04 04 04 00 04 04 04 04 04 04 04 04 04 04 04 04 04 04 04 04 04 04 04 04 04 04 04 04 04 04 04 04 04 04 04 04 04 04 00 00 04 04 