02 02 02 02 02 02 02 02 02 02 02 02 02 02 02 02 02 02 02 02 02 02 02 02 02 02 02 02 02 02 02 02 02 02 02 02 02 02 02 02 02 02 02 02 02 02 02 
02 02 02 02 02 02 02 02 02 02 02 02 02 02 02 02 02 02 02 02 02 02 02 02 02 02 02 02 02 02 02 02 02 02 02 02 02 02 02 02 02 02 02 02 02 02 02 
02 02 02 02 02 02 02 02 02 02 02 02 02 02 02 02 02 02 02 02 02 02 02 02 02 02 02 02 02 02 02 02 02 02 02 02 02 02 02 02 02 02 02 02 02 02 02 
02 02 02 02 02 02 02 02 02 02 02 02 02 02 02 02 02 02 02 02 02 02 02 02 02 02 02 02 02 02 02 02 02 02 02 02 02 02 02 02 02 02 02 02 02 02 02 
02 02 02 02 02 02 02 02 02 02 02 02 02 02 02 02 02 02 02 02 02 02 02 02 02 02 02 02 02 02 02 02 02 02 02 02 02 02 02 02 02 02 02 02 02 02 02 
02 02 02 02 02 02 02 02 02 02 02 02 02 02 02 02 02 02 02 02 02 02 02 02 02 02 02 02 02 02 02 02 02 02 02 02 02 02 02 02 02 02 02 02 02 02 02 
02 02 02 02 02 02 02 02 02 02 02 02 02 02 02 02 02 02 02 02 02 02 02 02 02 02 02 02 02 02 02 02 02 02 02 02 02 02 02 02 02 02 02 02 02 02 02 
02 02 02 02 02 02 02 02 02 02 02 02 02 02 02 02 02 02 02 02 02 02 02 02 02 02 02 02 02 02 02 02 02 02 02 02 02 02 02 02 02 02 02 02 02 02 02 
02 02 02 02 02 02 02 02 15 08 08 08 08 08 08 08 08 08 08 08 08 08 08 08 08 08 08 08 08 16 02 02 02 15 08 16 02 02 15 08 16 02 02 02 02 02 02 
02 02 02 02 02 02 02 02 09 03 03 03 05 05 05 05 05 03 03 03 03 03 03 03 05 05 03 03 03 11 16 02 02 09 03 10 02 02 09 03 10 02 02 02 02 02 02 
02 02 02 02 02 02 02 02 09 03 00 00 03 05 14 07 07 07 07 13 03 14 07 07 07 13 03 00 00 03 11 16 02 09 03 10 02 02 09 03 10 02 02 02 02 02 15 
02 02 02 02 02 02 02 02 09 03 00 00 00 03 10 02 02 02 02 09 03 10 02 02 02 09 03 00 00 00 03 10 02 09 03 10 02 02 09 03 10 02 02 02 02 03 03 
02 02 02 02 02 02 02 02 09 03 00 00 00 03 11 16 02 02 02 09 03 10 02 02 02 09 03 00 00 00 03 11 16 09 03 10 02 02 09 03 10 02 02 02 02 02 18 
02 02 02 02 02 02 02 15 12 03 00 00 00 00 03 10 02 02 02 09 03 10 02 02 02 09 03 00 00 00 00 03 11 12 03 11 08 08 12 03 10 02 02 02 02 02 02 
02 02 02 02 02 02 02 09 03 03 03 00 00 00 03 10 02 02 02 09 03 10 02 02 02 09 03 00 00 00 00 03 05 05 03 03 03 03 03 03 10 02 02 02 02 02 02 
02 02 02 02 02 02 02 18 13 03 00 00 00 00 03 10 02 02 02 09 03 10 02 02 02 09 03 00 00 00 00 03 14 13 03 14 07 07 13 03 10 02 02 02 02 02 02 
02 02 02 02 02 02 02 02 09 03 00 00 00 03 05 10 02 02 02 09 03 10 02 02 02 09 03 00 00 00 03 14 17 09 03 10 02 02 09 03 10 02 02 02 02 02 02 
02 02 02 02 02 02 02 02 09 03 00 00 00 03 14 17 02 02 02 09 03 10 02 02 02 09 03 00 00 00 03 10 02 09 03 10 02 02 09 03 10 02 02 02 02 02 02 
02 02 02 02 02 02 02 02 09 03 00 00 03 05 10 02 02 02 02 09 03 10 02 02 02 09 03 00 00 03 14 17 02 09 03 10 02 02 09 03 10 02 02 02 02 02 02 
02 02 02 02 02 02 02 02 09 03 03 03 14 07 17 02 02 02 02 09 03 10 02 02 02 09 03 03 03 05 10 02 02 09 03 10 02 02 09 03 10 02 02 02 02 02 02 
02 02 02 02 02 02 02 02 18 07 07 07 17 02 02 02 02 02 02 09 05 11 08 08 08 12 05 14 07 07 17 02 02 18 07 17 02 02 18 07 17 02 02 02 02 02 02 
02 02 02 02 15 08 16 02 02 15 08 08 16 02 02 02 02 02 02 09 03 03 03 03 03 03 03 10 02 02 15 16 02 02 02 02 02 15 16 02 02 02 15 16 02 02 02 
16 02 15 08 12 05 10 02 02 09 05 05 10 02 02 15 08 08 08 01 01 01 01 01 01 03 01 01 16 02 09 10 02 02 15 08 08 12 10 02 15 08 12 11 16 02 15 
11 08 12 00 00 05 11 08 08 12 05 05 11 16 02 09 00 00 05 05 05 05 05 01 01 03 03 01 11 08 12 11 08 08 12 01 01 05 11 08 12 05 05 05 11 08 12 
00 05 05 00 00 00 00 00 00 00 00 00 00 10 02 09 00 00 00 05 05 05 01 01 03 01 03 01 01 01 01 01 01 01 01 01 01 01 05 05 05 01 01 01 01 05 05 
