02 09 01 05 00 00 04 04 00 05 05 04 00 00 00 03 03 03 04 00 00 05 00 00 00 00 00 03 03 03 00 00 00 00 00 00 00 00 00 00 00 00 00 00 04 04 04 04 04 04
15 12 01 00 00 00 05 00 00 05 05 05 00 00 00 00 04 03 03 03 00 05 00 00 00 03 03 03 00 00 00 00 00 00 00 00 00 00 00 00 00 00 00 00 04 04 04 04 04 04
03 05 01 00 00 00 05 05 05 00 00 05 00 00 00 00 00 00 00 03 03 03 03 03 03 03 00 00 00 00 00 04 00 00 00 00 05 00 00 00 00 00 00 05 04 04 04 04 04 04
18 13 01 04 05 05 05 05 00 00 00 05 00 00 00 00 00 05 05 04 00 05 04 00 00 00 00 00 00 00 00 00 04 00 00 00 05 00 00 00 00 00 05 00 04 04 04 04 04 04
02 09 01 05 05 05 05 05 05 04 05 05 00 00 05 00 00 00 00 00 00 05 00 00 00 00 00 04 00 00 04 00 00 00 00 00 05 00 00 00 00 05 00 00 04 04 04 04 04 04
02 09 01 05 05 05 05 05 05 00 05 05 00 00 05 00 00 00 00 00 00 05 00 00 00 04 00 00 00 00 00 00 04 00 00 00 05 00 00 00 00 05 00 00 04 04 04 04 04 04
02 09 01 00 05 05 05 00 00 04 00 05 00 00 00 00 00 00 00 00 00 00 00 05 00 00 00 00 00 00 00 00 00 00 00 00 05 00 00 00 00 05 00 00 04 04 04 04 04 04
02 09 01 04 05 00 00 00 00 00 00 00 00 00 00 00 00 00 00 00 00 05 05 05 04 00 04 00 00 04 00 00 00 00 00 00 05 00 00 00 00 05 00 00 04 04 04 04 04 04
02 09 01 00 04 00 05 05 05 05 05 05 00 00 00 05 05 00 00 00 00 00 00 00 00 04 00 00 00 00 00 00 00 00 00 00 05 00 00 00 00 05 00 00 04 04 04 04 04 04
02 09 01 04 00 00 05 06 05 05 05 05 05 00 00 00 04 00 00 05 00 00 00 00 00 00 00 00 00 00 00 00 00 00 00 00 05 00 00 00 00 05 00 00 04 04 04 04 04 04
02 09 01 04 00 05 05 05 05 06 05 05 05 00 04 00 00 00 04 05 05 05 00 00 00 00 00 04 00 04 00 00 04 00 00 00 05 00 00 00 00 00 05 00 04 04 04 04 04 04
02 09 01 05 05 05 05 06 05 05 06 05 04 00 00 00 00 05 05 05 05 04 00 00 00 00 00 00 00 00 00 04 04 00 00 00 05 05 05 05 05 00 00 05 04 04 04 04 04 04
02 09 01 05 06 05 05 06 05 05 05 05 00 00 00 00 00 04 05 05 00 00 04 04 00 00 04 00 00 00 00 00 00 00 00 00 00 00 00 00 00 00 00 00 04 04 04 04 04 04
02 09 01 05 05 05 05 05 05 00 00 04 04 00 00 00 00 00 05 05 04 00 04 04 04 04 04 04 00 00 00 00 04 04 00 00 04 04 04 04 04 04 04 04 04 04 04 04 04 04
02 09 01 00 00 05 05 05 05 05 05 05 04 00 04 04 00 00 05 04 04 04 04 00 04 00 00 04 00 04 00 04 04 00 00 00 00 00 00 00 00 00 00 00 04 04 04 04 04 04
02 09 01 05 05 05 05 00 04 04 05 04 04 04 00 00 00 00 00 00 00 00 04 04 04 04 04 04 00 00 04 00 04 00 04 04 00 00 04 04 00 04 00 04 04 04 04 04 04 04
02 09 01 00 00 05 00 00 00 00 05 05 05 00 04 05 05 04 05 00 00 00 00 00 04 00 04 04 00 00 04 04 00 04 00 04 00 04 00 04 04 04 00 00 04 04 04 04 04 04
02 09 01 05 00 06 05 05 04 00 04 04 00 00 04 00 00 04 05 00 04 04 04 04 00 04 04 04 04 00 04 04 04 04 04 00 00 00 00 04 04 04 00 04 04 04 04 04 04 04
02 09 01 06 05 05 05 05 05 05 05 05 00 00 00 04 05 05 00 00 00 04 00 04 04 04 04 00 14 07 07 07 07 07 07 07 13 04 00 04 04 00 00 00 04 04 04 04 04 04
08 12 01 05 05 06 05 05 06 05 05 05 05 05 00 00 00 00 00 00 00 00 04 04 14 07 07 07 17 15 08 08 08 08 08 16 18 07 07 07 07 07 07 07 04 04 04 04 04 04
05 01 01 05 05 05 05 05 05 05 06 05 00 00 04 04 00 04 00 00 00 00 04 14 17 15 08 08 08 12 04 04 04 04 04 11 08 08 08 08 08 08 08 08 04 04 04 04 04 04
00 05 05 00 05 05 05 05 05 05 05 00 00 04 04 00 00 04 00 00 00 04 00 10 15 12 00 04 04 04 00 00 00 04 00 00 04 04 00 04 00 04 00 00 04 04 04 04 04 04
00 00 05 00 05 06 05 05 06 06 05 00 00 00 05 00 00 04 00 00 00 00 04 10 09 04 04 04 00 00 04 04 04 00 00 04 00 04 04 04 04 04 00 04 04 04 04 04 04 04
00 05 06 04 00 05 05 05 05 06 05 05 05 05 05 05 05 05 05 05 05 05 05 03 03 05 05 05 00 00 04 04 04 04 00 04 00 00 04 04 00 04 00 00 04 04 04 04 04 04
00 05 05 00 05 06 05 05 05 05 05 00 04 00 00 00 00 00 00 04 00 04 00 10 09 00 00 05 04 04 04 04 00 00 04 04 04 04 00 00 04 00 04 04 04 04 04 04 04 04
00 00 05 05 05 05 05 05 05 00 00 00 04 00 05 05 05 05 05 05 00 00 14 17 09 04 04 05 00 00 04 00 04 04 04 04 04 00 04 04 04 05 05 05 04 04 04 04 04 04
00 05 05 05 06 05 06 05 06 05 05 05 05 05 05 05 05 00 00 04 05 14 17 02 09 05 05 05 04 00 00 00 00 00 04 05 05 05 05 05 05 05 04 00 04 04 04 04 04 04
00 05 05 05 05 05 05 05 05 00 00 05 00 00 00 14 07 07 07 07 07 17 02 15 12 04 04 05 00 00 04 04 05 05 05 05 04 00 04 04 00 00 04 04 04 04 04 04 04 04
00 05 05 05 05 06 05 05 00 04 00 00 00 00 00 10 02 02 02 02 02 02 02 09 00 04 04 05 05 05 05 05 05 04 04 04 04 04 00 04 04 04 04 04 04 04 04 04 04 04
00 00 00 00 05 06 05 05 05 00 00 00 04 00 00 10 02 15 08 08 08 08 08 12 04 00 04 04 00 04 00 04 00 04 00 04 04 04 00 04 04 04 04 00 04 04 04 04 04 04
00 05 05 05 00 05 05 00 00 00 00 05 00 04 00 10 02 09 04 00 00 04 04 04 04 04 00 00 04 04 00 04 04 04 04 04 00 00 00 00 04 00 04 00 04 04 04 04 04 04
13 06 05 05 00 05 05 00 00 00 05 05 05 00 04 10 02 09 00 00 04 04 04 04 00 00 00 00 04 04 00 00 04 00 04 04 04 04 04 04 00 04 04 00 04 04 04 04 04 04
18 13 00 00 00 05 05 05 05 05 05 00 04 00 00 10 02 09 00 04 00 04 00 04 04 04 04 00 04 00 04 04 00 04 04 04 04 04 04 04 04 00 04 04 04 04 04 04 04 04
02 18 07 07 13 05 05 05 05 05 05 00 00 00 00 10 02 09 04 00 00 04 04 04 04 00 04 04 04 00 00 04 04 04 04 00 04 04 14 07 07 07 07 07 04 04 04 04 04 04
02 02 02 02 18 07 13 05 05 05 05 04 00 00 14 17 02 09 00 00 00 00 00 00 00 00 00 00 00 04 04 04 04 04 00 04 14 07 17 02 02 02 02 02 04 04 04 04 04 04
02 02 02 02 02 02 18 13 05 05 05 04 00 14 17 02 02 09 00 00 00 00 04 04 04 04 04 04 04 04 04 04 04 14 07 07 17 02 02 15 08 08 08 08 04 04 04 04 04 04
08 08 16 02 02 02 02 18 07 07 07 07 07 17 15 08 08 12 00 00 04 00 00 00 04 04 00 04 04 00 00 04 14 17 02 02 02 15 08 12 04 00 04 00 04 04 04 04 04 04
00 01 11 08 16 02 02 02 15 08 16 02 02 02 09 05 05 00 00 00 00 04 00 04 00 04 00 04 04 00 04 14 17 02 15 08 08 12 00 00 04 04 04 04 04 04 04 04 04 04
00 01 00 05 11 16 02 02 18 13 11 08 16 02 18 07 07 07 07 07 07 07 07 07 07 07 07 07 07 07 07 17 15 08 12 00 00 00 04 00 04 00 04 00 04 04 04 04 04 04
00 03 00 00 03 03 03 03 03 03 03 00 11 08 08 16 02 02 02 02 02 02 02 02 02 02 02 02 02 02 02 02 09 14 07 07 13 00 00 00 00 00 00 00 04 04 04 04 04 04
00 01 00 00 00 11 16 02 02 18 13 00 00 00 00 11 08 08 08 08 08 08 08 08 08 08 08 08 08 08 08 16 18 17 02 02 18 13 00 00 00 00 00 00 04 04 04 04 04 04
00 01 00 00 00 00 11 16 02 02 09 00 00 00 00 00 00 00 00 00 00 00 00 00 00 00 04 00 00 00 00 11 08 08 08 16 02 18 13 00 00 00 00 00 04 04 04 04 04 04
01 01 01 01 01 01 01 10 02 02 09 01 01 01 01 01 01 01 01 01 01 01 01 01 01 01 01 01 01 01 01 01 01 01 01 10 02 02 09 01 01 01 01 01 04 04 04 04 04 04
04 04 04 04 04 04 04 10 02 02 09 04 04 04 04 04 04 04 04 00 04 04 04 00 04 04 04 00 00 04 04 00 04 04 04 10 02 02 09 04 04 04 04 04 04 04 04 04 04 04
04 04 04 04 04 04 04 10 02 02 09 04 04 04 04 04 00 04 04 04 04 04 04 04 04 00 04 00 04 04 04 04 04 04 00 10 02 02 09 04 04 00 04 04 04 04 04 04 04 04
00 04 04 04 04 04 00 10 02 02 09 04 04 04 04 04 04 04 04 04 04 04 00 04 04 04 04 04 04 04 04 04 00 04 04 10 02 02 09 04 04 04 04 00 04 04 04 04 04 04
04 04 04 00 04 04 04 10 02 02 09 04 04 04 04 00 04 04 00 04 04 04 04 04 04 04 00 04 04 04 04 04 04 04 04 10 02 02 09 04 04 00 00 00 04 04 04 04 04 04
04 04 04 00 04 04 04 10 02 02 09 04 04 04 04 00 04 04 00 04 04 04 04 04 04 04 00 04 04 04 04 04 04 04 04 10 02 02 09 04 04 00 00 00 04 04 04 04 04 04
04 04 04 00 04 04 04 10 02 02 09 04 04 04 04 00 04 04 00 04 04 04 04 04 04 04 00 04 04 04 04 04 04 04 04 10 02 02 09 04 04 00 00 00 04 04 04 04 04 04
04 04 04 00 04 04 04 10 02 02 09 04 04 04 04 00 04 04 00 04 04 04 04 04 04 04 00 04 04 04 04 04 04 04 04 10 02 02 09 04 04 00 00 00 04 04 04 04 04 04