16 02 02 02 02 02 02 09 03 03 03 03 03 03 03 10 02 02 15 16 02 02 02 02 02 15 16 02 02 02 15 16 02 02 02 03 02 09 10 02 02 02 02 02 02 99 99 99 99 99
10 02 02 15 08 08 08 01 01 01 01 01 01 03 01 01 16 02 09 10 02 02 15 08 08 12 10 02 15 08 12 11 16 02 15 03 08 12 11 08 16 02 02 02 02 99 99 99 99 99
11 16 02 09 00 00 05 05 05 05 05 01 01 03 03 01 11 08 12 11 08 08 12 01 01 05 11 08 12 05 05 05 11 08 12 03 00 05 05 05 11 16 02 02 02 99 99 99 99 99
00 10 02 09 00 00 00 05 05 05 01 01 03 01 03 01 01 01 01 01 01 01 01 01 01 01 05 05 05 01 01 01 01 05 05 03 00 00 14 07 13 10 02 15 16 99 99 99 99 99
00 10 02 09 00 00 04 05 05 01 01 03 03 01 03 03 03 03 03 03 03 03 01 03 03 01 01 01 01 01 03 03 01 01 01 03 01 01 10 02 09 10 02 09 10 99 99 99 99 99
07 17 02 18 13 00 00 05 00 01 03 01 03 03 01 01 01 01 01 01 01 03 03 03 01 01 03 03 03 01 03 03 03 03 03 03 03 01 11 08 12 11 08 12 10 99 99 99 99 99
02 02 02 02 09 04 00 00 00 01 03 03 01 03 03 01 03 03 03 03 01 01 01 03 03 03 01 01 03 01 03 01 01 03 03 01 01 01 01 01 00 00 00 05 11 99 99 99 99 99
02 02 02 02 09 00 00 00 00 01 03 01 01 03 03 03 03 01 01 03 03 03 01 03 01 03 03 01 03 01 03 01 03 03 01 01 03 03 03 01 04 00 00 00 05 99 99 99 99 99
08 08 08 08 12 00 04 00 00 01 03 01 03 01 03 01 01 03 01 01 01 03 03 01 01 03 01 01 03 01 03 01 03 01 03 03 03 01 03 03 00 00 00 00 00 99 99 99 99 99
00 00 00 00 00 04 00 00 00 01 03 03 03 03 01 03 01 03 01 03 01 01 03 03 03 03 03 03 03 01 03 01 03 03 01 03 01 01 03 01 14 07 07 13 00 99 99 99 99 99
00 00 03 03 03 03 03 03 00 01 01 01 03 03 03 03 01 03 01 03 01 03 03 03 01 01 03 01 03 03 03 01 03 03 03 03 03 01 03 01 10 02 02 09 00 99 99 99 99 99
00 00 03 00 00 00 00 03 00 01 03 03 03 01 01 03 01 03 03 03 01 03 01 01 03 01 01 03 03 03 01 03 01 03 01 03 03 01 03 01 01 01 02 18 13 99 99 99 99 99
00 00 03 00 00 00 00 03 00 01 01 03 01 03 03 03 03 01 03 01 03 03 01 03 03 03 01 01 03 01 03 03 03 03 01 03 01 01 03 03 03 01 02 02 18 99 99 99 99 99
00 00 03 03 03 03 03 03 00 01 03 03 01 03 01 01 03 01 03 01 03 03 03 01 03 03 03 01 01 03 03 01 01 03 01 03 03 01 01 01 03 01 02 02 02 99 99 99 99 99
00 00 03 05 05 05 05 03 00 01 01 03 03 01 03 03 03 03 03 03 01 03 03 01 03 01 03 03 01 03 01 03 03 01 03 03 03 03 03 01 03 01 08 08 16 99 99 99 99 99
00 00 03 05 05 05 05 03 00 01 01 03 01 01 03 03 01 01 01 03 03 01 01 01 03 03 01 03 03 03 03 01 03 01 01 01 01 01 03 01 03 01 00 00 10 99 99 99 99 99
00 04 03 05 05 05 05 03 00 01 03 03 03 03 01 03 03 03 01 01 01 03 03 03 03 01 03 01 03 01 01 01 03 03 03 03 01 01 03 01 03 01 00 00 11 99 99 99 99 99
00 00 03 03 03 03 03 03 00 01 03 01 01 01 01 01 03 03 03 03 01 01 01 01 01 01 03 01 03 03 03 03 03 01 01 03 03 03 03 01 03 01 00 00 00 99 99 99 99 99
00 00 00 00 00 00 00 00 00 01 03 03 03 03 03 01 03 01 03 01 01 03 03 03 03 03 03 01 01 01 03 03 01 03 01 01 01 01 01 01 03 01 00 00 00 99 99 99 99 99
00 00 00 00 00 00 00 04 00 01 03 01 01 03 01 03 03 01 01 03 01 03 01 01 03 01 01 01 01 03 01 03 03 03 01 03 03 03 01 03 03 01 00 04 00 99 99 99 99 99
00 00 00 00 00 04 00 00 00 01 03 03 01 03 01 01 03 01 03 03 01 03 01 03 03 01 03 01 03 03 01 03 01 03 03 03 01 03 01 03 01 01 00 04 04 99 99 99 99 99
00 00 00 00 00 00 00 04 00 01 03 01 01 03 01 03 03 01 03 01 03 03 01 03 03 03 03 01 03 01 01 03 01 03 01 01 01 03 01 03 01 00 00 00 00 99 99 99 99 99
00 00 04 00 00 00 00 00 04 01 01 03 03 03 01 03 01 01 03 03 03 01 03 01 03 01 03 03 03 03 03 03 03 01 03 03 01 03 03 03 01 04 00 00 00 99 99 99 99 99
00 00 00 04 00 00 00 00 00 01 01 03 01 01 01 03 03 03 03 01 03 03 03 03 01 03 03 01 03 01 01 01 03 01 03 01 01 01 01 01 01 00 00 00 00 99 99 99 99 99
00 04 00 00 00 00 00 00 05 01 01 03 03 01 01 01 03 03 01 03 01 01 01 01 03 03 01 01 01 03 03 03 01 03 03 03 03 01 03 03 05 00 00 00 00 99 99 99 99 99
00 00 04 00 00 00 00 00 05 03 03 01 03 01 03 03 03 01 01 03 03 03 01 03 01 03 03 01 03 03 01 03 01 03 01 01 03 03 03 03 05 00 00 00 00 99 99 99 99 99
00 00 00 00 00 00 00 00 05 01 03 03 03 03 03 01 03 03 01 03 01 03 03 03 03 03 01 03 03 01 03 03 03 03 03 03 01 01 01 01 01 00 00 00 04 99 99 99 99 99
04 00 00 00 00 00 00 00 00 01 03 01 03 01 01 03 03 01 03 01 03 03 01 01 01 03 01 03 01 03 01 01 03 03 01 01 03 03 03 03 01 01 01 04 00 99 99 99 99 99
00 04 00 00 00 04 00 00 00 01 03 01 01 03 03 03 03 03 03 01 03 01 03 01 03 03 01 03 03 03 01 03 03 01 03 03 03 00 00 03 03 03 03 01 01 99 99 99 99 99
00 00 00 00 00 00 00 00 00 01 03 03 03 03 01 01 03 01 03 01 03 03 03 01 01 01 03 01 03 01 03 03 01 03 03 00 00 04 00 00 00 01 03 03 03 99 99 99 99 99
00 04 00 00 04 00 00 00 00 01 01 03 01 03 03 01 03 03 01 01 01 01 03 01 03 03 03 03 03 01 03 01 03 03 00 00 04 00 00 01 01 03 03 03 03 99 99 99 99 99
00 00 00 00 00 00 00 00 00 01 03 01 03 03 01 03 01 03 03 03 03 01 03 01 03 01 01 03 01 01 01 03 03 00 00 00 00 00 01 03 03 03 00 00 01 99 99 99 99 99
04 04 00 00 00 04 00 04 00 01 03 03 03 01 03 03 03 01 03 01 03 01 03 03 03 03 01 03 03 01 03 03 00 00 00 00 00 01 03 03 01 00 00 00 01 99 99 99 99 99
00 00 00 00 04 00 04 00 00 01 03 01 01 03 03 01 01 01 03 01 03 03 01 03 03 01 03 03 01 03 03 00 00 00 00 00 01 03 03 01 00 00 00 00 01 99 99 99 99 99
00 04 00 00 00 00 00 00 00 01 03 01 03 03 01 03 03 03 03 01 03 01 03 03 01 03 03 01 03 03 00 00 00 04 00 01 03 03 01 00 00 00 00 00 01 99 99 99 99 99
00 00 00 00 00 00 00 00 00 01 03 01 03 01 03 03 01 01 01 03 03 03 03 01 03 03 01 03 03 00 00 00 00 04 00 01 03 03 01 00 00 00 00 00 01 99 99 99 99 99
00 00 00 00 00 00 00 04 00 01 03 03 03 01 01 03 03 03 01 03 03 01 01 03 03 01 03 03 00 00 00 00 00 00 04 01 03 03 01 00 00 00 00 00 00 99 99 99 99 99
00 04 00 04 00 00 00 00 00 01 01 01 03 03 03 01 01 03 01 01 01 03 03 03 01 03 03 00 00 04 00 00 00 00 04 00 01 03 01 00 00 00 00 00 00 99 99 99 99 99
00 05 00 00 03 03 03 03 03 03 03 03 01 01 03 03 03 03 01 03 03 03 01 01 03 03 00 00 00 00 00 00 00 00 00 00 01 03 01 00 00 00 00 00 00 99 99 99 99 99
00 05 03 03 03 00 00 00 00 00 00 03 03 03 01 01 01 03 03 03 01 01 03 03 03 00 00 00 00 00 04 00 00 00 00 00 01 03 03 01 00 00 00 00 00 99 99 99 99 99
00 03 03 00 00 00 00 00 00 00 00 00 00 03 03 03 03 01 03 01 03 03 03 00 00 00 00 00 00 00 00 00 00 00 00 00 00 01 03 03 01 00 00 00 00 99 99 99 99 99
03 03 00 00 00 00 00 00 00 00 00 00 00 00 00 00 03 03 03 03 03 00 00 04 00 00 00 00 04 00 00 00 04 00 00 00 00 00 01 03 03 01 00 00 00 99 99 99 99 99
04 04 04 04 04 04 04 04 04 04 04 04 04 04 04 04 04 04 04 04 04 04 04 04 04 04 04 04 04 04 04 04 04 04 04 04 04 04 04 04 04 04 04 04 04 04 04 04 04 04 
04 04 04 04 04 04 04 04 04 04 04 04 04 04 04 04 04 04 04 04 04 04 04 04 04 04 04 04 04 04 04 04 04 04 04 04 04 04 04 04 04 04 04 04 04 04 04 04 04 04 
04 04 04 04 04 04 04 04 04 04 04 04 04 04 04 04 04 04 04 04 04 04 04 04 04 04 04 04 04 04 04 04 04 04 04 04 04 04 04 04 04 04 04 04 04 04 04 04 04 04 
04 04 04 04 04 04 04 04 04 04 04 04 04 04 04 04 04 04 04 04 04 04 04 04 04 04 04 04 04 04 04 04 04 04 04 04 04 04 04 04 04 04 04 04 04 04 04 04 04 04 
04 04 04 04 04 04 04 04 04 04 04 04 04 04 04 04 04 04 04 04 04 04 04 04 04 04 04 04 04 04 04 04 04 04 04 04 04 04 04 04 04 04 04 04 04 04 04 04 04 04 
04 04 04 04 04 04 04 04 04 04 04 04 04 04 04 04 04 04 04 04 04 04 04 04 04 04 04 04 04 04 04 04 04 04 04 04 04 04 04 04 04 04 04 04 04 04 04 04 04 04 
04 04 04 04 04 04 04 04 04 04 04 04 04 04 04 04 04 04 04 04 04 04 04 04 04 04 04 04 04 04 04 04 04 04 04 04 04 04 04 04 04 04 04 04 04 04 04 04 04 04 
04 04 04 04 04 04 04 04 04 04 04 04 04 04 04 04 04 04 04 04 04 04 04 04 04 04 04 04 04 04 04 04 04 04 04 04 04 04 04 04 04 04 04 04 04 04 04 04 04 04 