22 22 22 22 22 22 22 22 22 22 22 22 22 22 22 22 22 22 22 22 22 22 22 22 22 22 22 22 22 22 
22 22 22 21 21 21 21 21 22 22 21 21 21 21 21 22 21 21 21 21 21 22 22 22 22 22 22 22 22 22 
22 22 21 21 28 30 30 21 21 21 21 30 30 30 21 21 21 30 30 30 21 21 22 22 22 22 22 22 22 22 
22 22 21 30 34 28 30 30 30 30 30 30 30 30 30 30 30 37 30 38 30 21 21 21 22 22 22 22 22 22 
22 22 21 30 66 66 66 30 28 30 30 66 40 80 30 40 45 47 73 49 30 21 30 21 21 22 22 22 22 22 
22 21 21 42 66 21 66 66 66 84 66 66 66 66 66 21 80 37 42 45 47 30 84 30 21 22 22 22 22 22 
22 21 36 42 66 21 21 71 66 81 30 81 21 66 66 84 21 21 42 21 47 30 78 30 21 22 22 22 22 22 
22 21 30 42 76 21 36 80 66 85 38 85 30 21 66 78 30 30 42 21 66 66 66 21 21 22 22 22 22 22 
22 21 83 84 21 21 36 42 66 66 40 49 30 21 66 66 66 66 66 21 30 21 66 21 21 21 21 22 22 22 
22 21 21 21 21 36 66 66 21 43 66 40 28 21 30 30 42 30 30 21 30 21 66 30 24 30 21 21 22 22 
22 21 30 30 23 28 42 84 21 32 66 66 66 21 30 30 42 30 30 21 21 21 42 30 29 31 30 21 22 22 
22 21 26 27 34 66 42 78 21 26 27 66 66 21 30 30 66 66 49 66 66 21 43 66 49 35 41 21 21 22 
22 21 27 21 21 66 66 21 21 27 21 66 66 21 30 84 48 48 48 66 66 21 32 66 66 22 26 30 21 22 
22 21 42 41 25 66 84 21 21 21 66 66 21 21 30 78 66 66 66 21 21 21 21 21 25 66 50 74 21 22 
22 21 21 80 27 50 21 22 22 21 66 66 21 30 30 66 66 47 21 21 22 22 22 21 67 68 70 72 21 22 
22 21 80 65 50 21 21 22 22 21 66 66 21 21 66 66 84 21 21 22 22 22 22 21 21 50 77 21 21 22 
22 21 21 74 77 21 22 22 22 21 66 21 21 21 21 21 21 22 22 22 22 22 22 22 21 21 21 21 22 22 
22 22 21 21 21 21 22 22 22 21 21 21 22 22 22 22 22 22 22 22 22 22 22 22 22 22 22 22 22 22 
22 22 22 22 22 22 22 22 22 22 22 22 22 22 22 22 22 22 22 22 22 22 22 22 22 22 22 22 22 22 
21 21 21 21 21 21 21 21 21 21 21 21 21 21 21 21 21 21 21 21 21 21 21 21 21 21 21 21 21 21 
